{
  "ground": [
    [3,7,4,2,1,3,5,4,5,1,1,0,0,1,2,5,7,2,6,7,7,5,0,4,0,0,0,0,0,0,1,0],
    [0,0,0,4,1,7,3,7,7,6,2,1,5,2,0,4,6,5,5,3,4,2,6,7,3,3,7,0,0,0,0,0],
    [1,2,2,6,3,6,3,1,5,1,2,4,5,3,6,2,2,1,6,14,14,14,14,14,2,0,4,3,0,0,0,0],
    [2,1,5,2,3,4,3,1,6,5,5,3,3,4,5,1,4,3,1,14,14,14,14,14,0,2,0,0,1,0,0,0],
    [0,5,4,5,0,0,5,5,1,3,3,5,7,3,6,7,5,2,5,14,14,14,14,14,5,7,4,2,6,1,1,0],
    [7,0,0,1,4,1,3,5,2,2,3,2,6,4,7,3,2,5,0,14,14,14,14,14,2,5,7,3,0,3,0,1],
    [3,7,5,3,2,5,1,1,1,13,13,7,6,6,1,3,2,3,0,14,14,14,14,14,0,1,7,0,0,2,2,2],
    [0,6,2,4,5,1,2,4,3,3,3,3,5,4,6,7,5,0,0,2,0,1,5,1,0,7,2,0,0,0,2,1],
    [0,3,2,3,5,2,4,1,13,5,13,2,5,6,2,7,7,0,0,2,2,0,2,0,1,1,6,7,2,4,0,2],
    [0,2,2,1,4,3,3,3,13,13,13,13,13,2,1,13,4,4,3,2,1,5,3,1,0,4,0,2,4,0,0,0],
    [1,0,0,3,4,5,1,0,13,13,2,13,5,13,3,4,5,2,3,1,2,6,6,0,0,0,0,2,0,0,0,1],
    [2,0,1,13,0,4,4,3,5,1,7,2,4,13,13,4,7,7,7,0,0,3,2,1,17,17,17,17,0,17,17,0],
    [1,0,1,1,0,7,3,13,1,5,4,4,3,7,13,13,13,3,7,3,0,7,0,0,17,17,17,17,17,17,17,0],
    [2,0,0,2,0,0,0,7,0,4,5,7,7,1,13,13,13,4,7,1,6,0,2,2,17,17,17,17,17,17,17,17],
    [0,0,0,0,0,0,2,2,18,0,4,0,13,3,3,13,13,7,1,0,2,0,2,2,17,17,17,17,17,17,17,17],
    [0,0,2,0,18,6,18,15,15,18,5,0,1,7,1,13,13,0,0,6,6,1,5,0,17,17,17,17,17,17,0,0],
    [2,0,0,18,18,2,11,15,15,11,18,7,0,2,2,1,13,6,2,16,16,0,5,6,7,0,0,0,0,0,1,0],
    [0,0,0,18,18,15,15,15,15,15,15,4,0,1,0,0,1,2,8,16,16,16,16,1,5,0,0,0,0,0,0,1],
    [0,0,0,7,7,15,11,15,12,11,15,18,1,1,4,16,16,16,8,16,16,16,16,2,6,7,7,0,0,0,0,2],
    [0,0,2,0,7,2,15,15,15,15,18,18,2,7,1,0,16,16,8,16,16,16,16,5,0,4,0,0,0,0,0,0],
    [0,8,8,8,8,8,8,8,15,8,14,14,14,14,1,0,16,16,8,16,16,16,3,6,3,3,3,0,0,2,2,0],
    [0,8,8,8,8,8,8,3,8,8,14,14,14,14,0,0,17,17,8,17,17,17,17,17,3,0,4,0,0,0,1,2],
    [0,8,8,8,8,8,8,8,8,8,14,14,14,14,0,0,8,17,8,17,8,8,17,17,6,1,0,2,0,0,1,1],
    [0,8,8,8,8,8,8,8,8,0,14,14,14,14,17,8,8,8,17,8,8,8,17,17,3,0,0,5,1,2,0,0],
    [1,8,8,8,8,8,8,8,8,1,14,14,14,14,17,17,8,17,8,17,8,17,17,17,3,0,7,6,0,2,0,0],
    [0,8,8,8,8,8,0,8,8,0,14,14,14,14,0,17,17,8,8,8,17,17,17,17,0,4,7,0,2,0,2,0],
    [0,8,0,8,8,0,8,8,8,0,14,14,14,14,2,6,17,17,8,17,17,17,0,2,2,4,5,2,3,0,0,2],
    [0,8,8,1,0,6,0,0,2,0,14,14,14,14,0,0,17,17,17,17,17,4,1,2,0,2,6,4,6,5,3,0],
    [0,8,8,8,8,8,8,8,8,8,14,14,14,14,14,0,2,0,3,0,4,5,4,2,3,1,4,1,4,0,0,0],
    [0,0,0,0,0,2,0,0,0,1,5,3,14,14,14,0,0,0,0,0,0,0,3,4,5,7,4,7,7,6,5,0],
    [0,6,1,0,0,2,2,0,2,0,5,3,14,14,14,6,0,0,0,5,0,0,0,0,0,6,6,4,7,0,7,2],
    [0,0,0,0,14,14,14,14,14,14,14,14,14,14,14,0,0,0,0,0,0,0,0,0,0,0,0,0,1,0,0,0]
  ],
  "height": [
    [8,3,4,2,4,5,3,2,4,2,8,6,4,0,0,0,0,0,0,0,0,0,0,0,0,0,0,0,0,0,0,0],
    [5,4,3,2,0,3,1,3,6,5,2,0,3,0,0,0,0,0,0,0,0,0,0,0,0,0,0,0,0,0,0,0],
    [4,2,4,1,1,3,1,2,3,0,0,0,0,0,0,0,0,0,0,0,0,0,0,0,0,0,0,0,0,0,0,0],
    [6,2,1,1,0,0,0,0,0,0,0,0,0,0,0,0,0,0,0,0,0,0,0,0,0,0,0,0,0,0,0,0],
    [8,5,0,0,0,0,0,0,0,0,0,0,0,0,0,0,0,0,0,0,0,0,0,0,0,0,0,0,0,0,0,0],
    [3,3,1,0,0,0,0,0,0,0,0,0,0,0,0,0,0,0,0,0,0,0,0,0,0,0,0,0,0,0,0,0],
    [5,0,0,0,0,2,2,0,1,0,0,0,0,0,0,0,0,0,0,0,0,0,0,0,0,0,0,0,0,0,0,0],
    [2,0,0,0,0,0,0,0,3,0,0,0,0,0,0,0,0,0,0,0,0,0,0,0,0,0,0,0,0,0,0,0],
    [1,0,0,0,0,0,6,6,4,1,0,0,0,0,0,0,0,0,0,0,0,0,0,0,0,0,0,0,0,0,0,0],
    [0,0,0,0,0,6,5,6,3,2,0,0,0,0,0,0,3,2,0,0,0,0,0,0,0,0,0,0,0,0,0,0],
    [0,0,0,0,0,5,5,0,0,0,0,0,1,0,0,0,2,1,0,0,0,0,0,0,0,0,0,0,0,0,0,0],
    [0,0,0,0,1,5,4,0,0,0,0,0,0,0,0,0,0,0,0,0,0,0,0,0,0,0,0,0,0,0,0,0],
    [0,0,0,0,0,4,4,0,0,0,0,0,0,0,0,0,0,0,0,0,0,0,0,0,0,0,0,0,0,0,0,0],
    [0,0,0,0,0,0,0,0,0,0,0,0,0,0,0,0,0,0,0,0,0,0,0,0,0,0,0,0,0,0,0,0],
    [0,0,0,0,0,0,0,0,0,0,0,0,0,0,0,0,0,0,0,0,0,0,0,0,0,0,0,0,0,0,0,0],
    [0,0,0,0,0,0,0,0,0,0,0,0,0,0,0,0,0,0,0,0,0,0,0,0,0,0,0,0,0,0,0,0],
    [0,0,0,0,0,0,0,0,0,0,0,0,0,0,0,0,0,0,0,0,0,0,0,0,0,0,0,0,0,0,0,0],
    [0,0,0,0,0,0,0,0,0,0,0,0,0,0,0,0,0,0,0,0,0,0,0,0,0,0,0,0,0,0,0,0],
    [0,0,0,0,0,0,0,0,0,0,0,0,0,0,0,0,0,0,0,0,0,0,0,0,0,0,0,0,0,0,0,0],
    [0,0,0,0,0,0,0,0,0,0,0,0,0,0,0,0,0,0,0,0,0,0,0,0,0,0,0,0,0,0,0,0],
    [0,0,0,0,0,0,0,0,0,0,0,0,0,0,0,0,0,0,0,0,0,0,0,0,0,0,0,0,0,0,0,0],
    [0,0,0,0,0,0,0,0,0,0,0,0,0,0,0,0,0,0,0,0,0,0,0,0,0,0,0,0,0,0,0,0],
    [0,0,0,0,0,0,0,0,0,0,0,0,0,0,0,0,0,0,0,0,0,0,0,0,0,0,0,0,0,0,0,0],
    [0,0,0,0,0,0,0,0,0,0,0,0,0,0,0,0,0,0,0,0,0,0,0,0,0,0,0,0,0,0,0,0],
    [0,0,0,0,0,0,0,0,0,0,0,0,0,0,0,0,0,0,0,0,0,0,0,0,0,0,0,0,0,0,0,0],
    [0,0,0,0,0,0,0,0,0,0,0,0,0,0,0,0,0,0,0,0,0,0,0,0,0,0,0,0,0,0,0,0],
    [0,0,0,0,0,0,0,0,0,0,0,0,0,0,0,0,0,0,0,0,0,0,0,0,0,0,0,0,0,0,0,0],
    [0,0,0,0,0,0,0,0,0,0,0,0,0,0,0,0,0,0,0,0,0,0,0,0,0,0,0,0,0,0,0,0],
    [0,0,0,0,0,0,0,0,0,0,0,0,0,0,0,0,0,0,0,0,0,0,0,0,0,0,0,0,0,0,0,0],
    [0,0,0,0,0,0,0,0,0,0,0,0,0,0,0,0,0,0,0,0,0,0,0,0,0,0,0,0,0,0,0,0],
    [0,0,0,0,0,0,0,0,0,0,0,0,0,0,0,0,0,0,0,0,0,0,0,0,0,0,0,0,0,0,0,0],
    [0,0,0,0,0,0,0,0,0,0,0,0,0,0,0,0,0,0,0,0,0,0,0,0,0,0,0,0,0,0,0,0]
  ],
  "objects": [
    [15,15,0,0,15,15,15,15,0,15,0,15,0,15,0,0,0,0,0,0,0,0,0,0,0,0,0,0,0,0,0,0],
    [15,15,15,0,0,15,0,0,0,15,15,15,0,15,0,0,0,0,3,1,1,1,1,1,9,0,0,0,0,0,0,0],
    [15,0,15,15,0,15,0,0,0,15,43,0,0,0,0,0,0,0,2,10,8,0,0,2,9,9,0,0,0,0,0,0],
    [15,15,15,0,15,43,0,15,0,15,0,43,0,0,0,0,0,0,2,0,0,0,0,0,0,8,0,0,0,0,0,0],
    [15,0,15,0,0,0,0,0,0,0,0,0,0,0,0,0,0,0,2,0,0,0,28,0,0,0,0,0,0,0,0,0],
    [15,15,0,0,0,25,0,0,0,0,0,0,0,0,0,0,0,0,2,0,0,0,0,0,0,0,0,0,0,0,0,0],
    [0,15,0,0,0,0,0,0,0,0,0,0,0,0,0,0,0,0,2,1,0,0,0,0,0,0,0,0,0,0,0,0],
    [0,0,0,0,0,0,0,0,0,0,0,0,0,0,0,0,0,0,0,8,0,0,0,0,0,0,0,0,0,0,0,0],
    [0,15,0,0,0,0,0,0,0,0,0,0,0,0,0,0,0,0,0,0,0,0,0,0,0,0,15,0,0,0,0,0],
    [0,0,0,0,0,0,0,0,0,0,0,0,0,0,0,0,47,0,0,0,0,0,0,0,0,0,0,0,15,0,0,0],
    [15,15,0,0,0,0,0,0,0,0,0,0,0,0,0,0,0,0,47,15,0,0,0,3,1,1,1,19,19,1,1,0],
    [0,0,0,0,0,0,0,0,0,0,0,0,0,0,0,0,0,47,0,0,0,0,0,2,24,22,21,38,39,0,2,0],
    [0,0,0,0,0,0,0,0,0,0,0,0,0,0,0,0,0,0,0,0,0,0,0,2,0,0,0,0,0,0,2,0,0],
    [0,0,0,0,0,0,0,0,0,0,0,0,0,0,0,0,0,0,0,0,0,15,0,2,0,0,0,0,0,0,0,0],
    [0,0,0,0,0,0,0,0,0,0,0,0,0,0,0,0,0,0,0,0,0,15,0,2,0,0,0,0,0,0,0,0],
    [0,0,0,0,0,0,0,0,0,0,0,0,0,0,0,0,0,0,0,0,0,0,15,2,34,34,34,34,35,34,6,0],
    [0,0,0,0,0,0,0,0,0,0,0,0,0,0,0,0,0,0,0,10,0,0,0,0,0,0,0,0,0,0,0,0],
    [0,0,0,0,0,0,0,0,0,0,0,0,15,0,0,0,26,26,0,26,26,27,26,0,0,0,0,0,0,0,0,0],
    [0,0,0,0,0,0,0,0,0,15,15,15,15,15,0,0,27,26,0,0,0,26,26,0,0,0,0,0,0,0,0,0],
    [3,19,4,19,4,4,19,4,4,19,36,36,36,15,15,43,0,10,0,0,0,0,10,0,0,0,0,15,0,0,15,0],
    [2,39,24,38,22,21,0,20,0,2,0,0,0,0,15,27,26,26,0,0,25,0,0,25,0,0,0,0,0,15,0,0],
    [2,0,0,0,0,0,0,0,0,2,0,0,0,0,15,0,0,0,0,0,0,0,0,0,0,0,0,0,0,0,0,0],
    [2,0,0,10,10,0,0,0,0,2,0,0,0,0,15,43,0,0,0,0,0,0,0,0,0,0,0,0,0,0,0,0],
    [2,0,0,0,33,0,0,0,0,2,0,0,0,0,0,0,0,0,0,0,0,0,0,25,0,0,25,0,0,0,0,0],
    [2,0,0,0,0,0,0,0,0,2,0,30,0,0,0,0,0,0,0,0,0,0,0,0,0,0,0,0,0,0,0,0],
    [2,0,0,0,0,0,0,0,0,2,0,0,0,0,0,0,0,0,0,0,0,0,0,0,0,0,0,0,0,0,0,0],
    [2,0,0,0,0,0,0,0,0,2,0,0,0,0,0,0,0,0,0,0,0,0,0,0,0,0,0,0,0,0,0,0],
    [2,0,0,46,29,46,29,18,4,7,0,0,0,0,0,0,0,0,0,0,0,0,0,0,0,0,0,0,0,0,0,0],
    [2,0,0,0,0,0,0,0,0,0,0,0,0,0,0,0,0,0,0,0,13,13,0,0,0,0,0,0,0,0,0,0],
    [0,4,4,4,17,17,17,17,17,17,0,0,0,0,0,0,0,0,0,0,13,13,0,0,0,0,0,0,0,0,0,0],
    [0,0,0,0,0,0,0,0,0,0,0,43,0,0,0,0,0,0,0,0,0,0,0,0,0,0,0,0,0,0,0,0],
    [0,0,0,0,0,0,0,0,0,0,0,0,0,0,0,0,0,0,0,0,0,0,0,0,0,0,0,0,0,0,0,0]
  ],
  "particles": [
    [0,0,0,0,0,0,0,0,0,0,0,0,0,0,0,0,0,0,0,0,0,0,0,0,0,0,0,0,0,0,0,0],
    [0,0,0,0,0,0,0,0,0,0,0,0,0,0,0,0,0,0,0,0,0,0,0,0,0,0,0,0,0,0,0,0],
    [0,0,0,0,0,0,0,0,0,0,0,0,0,0,0,0,0,0,0,0,0,0,0,0,0,0,0,0,0,0,0,0],
    [0,0,0,0,0,0,0,0,0,0,0,0,0,0,0,0,0,0,0,0,0,0,0,0,0,0,0,0,0,0,0,0],
    [0,0,0,0,0,0,0,0,0,0,0,0,0,0,0,0,0,0,0,0,0,0,"fire",0,0,0,0,0,0,0,0,0],
    [0,0,0,0,0,"candleFire",0,0,0,0,0,0,0,0,0,0,0,0,0,0,0,0,0,0,0,0,0,0,0,0,0,0],
    [0,0,0,0,0,0,0,0,0,0,0,0,0,0,0,0,0,0,0,0,0,0,0,0,0,0,0,0,0,0,0,0],
    [0,0,0,0,0,0,0,0,0,0,0,0,0,0,0,0,0,0,0,0,0,0,0,0,0,0,0,0,0,0,0,0],
    [0,0,0,0,0,0,0,0,0,0,0,0,0,0,0,0,0,0,0,0,0,0,0,0,0,0,0,0,0,0,0,0],
    [0,0,0,0,0,0,0,0,0,0,0,0,0,0,0,0,"well",0,0,0,0,0,0,0,0,0,0,0,0,0,0,0],
    [0,0,0,0,0,0,0,0,0,0,0,0,0,0,0,0,0,0,"well",0,0,0,0,0,0,0,0,0,0,0,0,0],
    [0,0,0,0,0,0,0,0,0,0,0,0,0,0,0,0,0,"well",0,0,0,0,0,0,0,0,0,0,0,0,0,0],
    [0,0,0,0,0,0,0,0,0,0,0,0,0,0,0,0,0,0,0,0,0,0,0,0,0,0,0,0,0,0,0,0],
    [0,0,0,0,0,0,0,0,0,0,0,0,0,0,0,0,0,0,0,0,0,0,0,0,0,0,0,0,0,0,0,0],
    [0,0,0,0,0,0,0,0,0,0,0,0,0,0,0,0,0,0,0,0,0,0,0,0,0,0,0,0,0,0,0,0],
    [0,0,0,0,0,0,0,0,0,0,0,0,0,0,0,0,0,0,0,0,0,0,0,0,0,0,0,0,0,0,0,0],
    [0,0,0,0,0,0,0,0,0,0,0,0,0,0,0,0,0,0,0,0,0,0,0,0,0,0,0,0,0,0,0,0],
    [0,0,0,0,0,0,0,0,0,0,0,0,0,0,0,0,0,0,0,0,0,0,0,0,0,0,0,0,0,0,0,0],
    [0,0,0,0,0,0,0,0,0,0,0,0,0,0,0,0,0,0,0,0,0,0,0,0,0,0,0,0,0,0,0,0],
    [0,0,0,0,0,0,0,0,0,0,0,0,0,0,0,0,0,0,0,0,0,0,0,0,0,0,0,0,0,0,0,0],
    [0,0,0,0,0,0,0,0,0,0,0,0,0,0,0,0,0,0,0,0,"candleFire",0,0,"candleFire",0,0,0,0,0,0,0,0],
    [0,0,0,0,0,0,0,0,0,0,0,0,0,0,0,0,0,0,0,0,0,0,0,0,0,0,0,0,0,0,0,0],
    [0,0,0,0,0,0,0,0,0,0,0,0,0,0,0,0,0,0,0,0,0,0,0,0,0,0,0,0,0,0,0,0],
    [0,0,0,0,0,0,0,0,0,0,0,0,0,0,0,0,0,0,0,0,0,0,0,"candleFire",0,0,"candleFire",0,0,0,0,0],
    [0,0,0,0,0,0,0,0,0,0,0,0,0,0,0,0,0,0,0,0,0,0,0,0,0,0,0,0,0,0,0,0],
    [0,0,0,0,0,0,0,0,0,0,0,0,0,0,0,0,0,0,0,0,0,0,0,0,0,0,0,0,0,0,0,0],
    [0,0,0,0,0,0,0,0,0,0,0,0,0,0,0,0,0,0,0,0,0,0,0,0,0,0,0,0,0,0,0,0],
    [0,0,0,0,0,0,0,0,0,0,0,0,0,0,0,0,0,0,0,0,0,0,0,0,0,0,0,0,0,0,0,0],
    [0,0,0,0,0,0,0,0,0,0,0,0,0,0,0,0,0,0,0,0,0,0,0,0,0,0,0,0,0,0,0,0],
    [0,0,0,0,0,0,0,0,0,0,0,0,0,0,0,0,0,0,0,0,0,0,0,0,0,0,0,0,0,0,0,0],
    [0,0,0,0,0,0,0,0,0,0,0,0,0,0,0,0,0,0,0,0,0,0,0,0,0,0,0,0,0,0,0,0],
    [0,0,0,0,0,0,0,0,0,0,0,0,0,0,0,0,0,0,0,0,0,0,0,0,0,0,0,0,0,0,0,0]
  ]
}