{
"ground":		[[0,0,0,0,0,0,0,0,0,0],
				[0,1,1,1,1,1,1,1,1,0],
				[0,1,1,1,1,1,1,1,1,0],
				[1,1,1,1,1,1,1,1,1,1],
				[1,1,1,1,1,1,1,1,1,1],
				[1,1,1,1,1,1,1,1,1,1],
				[0,1,1,1,1,1,1,1,1,0],
				[0,1,1,1,1,1,1,1,1,0],
				[0,1,1,1,1,1,1,1,1,0],
				[0,0,0,0,0,0,0,0,0,0]],
"height":	[[2,1,1,1,1,1,1,1,1,2],
				[1,0,0,0,0,0,0,0,0,1],
				[1,0,0,0,0,0,0,0,0,1],
				[0,0,0,0,0,0,0,0,0,0],
				[0,0,0,0,0,0,0,0,0,0],
				[0,0,0,0,0,0,0,0,0,0],
				[1,0,0,0,0,0,0,0,0,1],
				[1,0,0,0,0,0,0,0,0,1],
				[1,0,0,0,0,0,0,0,0,1],
				[2,1,1,1,1,1,1,1,1,2]],
"objects":		[[1,1,1,1,1,1,1,1,1,1],
				[1,0,0,0,0,0,0,0,0,1],
				[1,0,0,0,0,0,0,0,0,1],
				[0,0,0,0,0,0,0,0,0,0],
				[0,0,0,0,0,0,0,0,0,0],
				[0,0,0,0,0,0,0,0,0,0],
				[1,0,0,0,0,0,0,0,0,1],
				[1,0,0,0,0,0,0,0,0,1],
				[1,0,0,0,0,0,0,0,0,1],
				[1,1,1,1,1,1,1,1,1,1]]
}